-E----E----R-----E-
----E--E---E------E
-E--E--E-R-E-----E-
--E-EE-E---E---R--E
-E--E--E-R-E------E
----E-EEE--E-----E-
----E--E---E---E---
----E--E-R-EE---EE-
----E--EEE-EE----E-
----E--E-R--E-E-E-E